R 900 900 
F 96,96,96
C 255,0,0

NO ./srcs/textures/north.xpm
SO ./srcs/textures/south.xpm
WE ./srcs/textures/west.xpm
EA ./srcs/textures/east.xpm
S ./srcs/textures/pillar.xpm

111111111
100000001
100202001
100010001
100020001
102000201
100000001
1000N0001
111111111

