R 600 600
F 220,100,0
C 225,30,0

NO ./srcs/textures/north.xpm
SO ./srcs/textures/south.xpm
WE ./srcs/textures/west.xpm
EA ./srcs/textures/east.xpm
S ./srcs/textures/pillar.xpm

11111111111
10000100001          11111
10000000001111111    10001
10000000000000001111110001
10000000000000000000000001
10000S00000000001111100001
10000000001111111    11111
10000000001
10000200001
10000000001
10000002001
10200000001
11111111111
